original	unit
micron	micron
inch	inch
meter	meter
angstrom	angstrom
decimeter	decimeter
centimeter	centimeter
millimeter	millimeter
micrometer	micrometer
nanometer	nanometer
picometer	picometer
kilogram	kilogram
picogram	picogram
nanogram	nanogram
microgram	microgram
milligram	milligram
gram	gram
ounce	ounce
pound	pound
mole	mole
picomole	picomole
nanomole	nanomole
micromole	micromole
millimole	millimole
picomolar	picomolar
nanomolar	nanomolar
micromolar	micromolar
millimolar	millimolar
Molar	Molar
liter	liter
nanoliter	nanoliter
microliter	microliter
milliliter	milliliter
picoliter	picoliter
pint (US)	pint (US)
quart (US)	quart (US)
gallon (US)	gallon (US)
milligrams per liter	milligram/liter
milligrams per milliliter	milligram/milliliter
nanograms per liter	nanogram/liter
nanograms per milliliter	nanogram/milliliter
micrograms per liter	microgram/liter
micrograms per milliliter	microgram/milliliter
grams per milliliter	gram/milliliter
grams per liter	gram/liter
base pair	basepair
kilo base pair	kilo basepair
mega base pair	mega basepair
giga base pair	giga basepair
pascal	pascal
pound per square inch	pound per square inch
bar	bar
millimeter mercury	millimeter mercury
Square Angstroms	Square Angstroms
square meter	square meter
hour	hour
millisecond	millisecond
day	day
year	year
week	week
second	second
minute	minute
percent by volume	percent by volume
purity by volume	purity by volume
millimole/liter	millimole/liter
nanomole/liter	nanomole/liter
micromoles per Liter	micromoles per Liter
microliter/hour	microliter/hour
milliliter/second	milliliter/second
purity by weight	purity by weight
percent by weight	percent by weight
milligram/kilogram	milligram/kilogram
milligram/gram	milligram/gram
microgram/gram	microgram/gram
microgram/kilogram	microgram/kilogram
gram/kilogram	gram/kilogram
weight percent	weight percent
milligram/deciliter	milligram/deciliter
milligram/cubic meter	milligram/cubic meter
microgram/liter	microgram/liter
vg per iu	vg per iu
degrees Celsius	degrees Celsius
Absorbance Units	Absorbance Units
Milli Absorbance Units	Milli Absorbance Units
Absorbance Units Seconds	Absorbance Units Seconds
Milli Absorbance Units Seconds	Milli Absorbance Units Seconds
kilodalton	kilodalton
extinction coefficient	extinction coefficient
cells per milliliter	cells per milliliter
Plaque-Forming Units per milliliter	Plaque-Forming Units per milliliter
Colony-Forming Units per milliliter	Colony-Forming Units per milliliter
enzyme units per milliliter	enzyme units per milliliter
vector genome per milliliter	vector genome per milliliter
Infectious units per milliliter	Infectious units per milliliter
Transducing Units per milliliter	Transducing Units per milliliter
TCID50 per milliliter	TCID50 per milliliter
viral particles per milliliter	viral particles per milliliter
genome copies per milliliter	genome copies per milliliter
optical density per milliliter	optical density per milliliter
beads per milliliter	beads per milliliter
particles per milliliter	particles per milliliter
molecules per milliliter	molecules per milliliter
Capsids per milliliter	Capsids per milliliter
lipid particles per milliliter	lipid particles per milliliter
kilograms per liter	kilograms per liter
cells per liter	cells per liter
viral particles per liter	viral particles per liter
cells per square centimeter	cells per square centimeter
micromole per gram	micromole per gram
cells per vial	cells per vial